####################
#P        #####    #
#   ##            K#
#########          #
#              #   #
#    ###           #
#     ########     #
#        ###       #
#                 ##
#         K        #
#   ##########     #
#      ##          #
##  K             D#
####################
####################