####################
#D                 #
#  #              K#
#    ##  ##    #   #
#                  #
#        #####     #
#                  #
#K            ###  #
#          K       #
#   ##########     #
#             #    #
#                  #
#                ###
#P         ###     #
####################
