####################
#    ##  K######## #
#                  #
#   ##             #
#P ###    ####     #
#############     D#
#                  #
#K       ##        #
#      #####       #
#        ###    #  #
#  ######          #
##      ######    ##
##        K    #####
###########      ###
####################
