####################
#K                ##
#                 K#
#                ###
#   #####  ##      #
# ##       ####    #
# ## ########    ###
# ##        #      #
# ######### #  #   #
# #         #      #
#D# ##########     #
###           ##   #
############# ##  ##
#K            ##  P#
####################
