####################
####################
####################
####################
####################
#P       #####     #
#                  #
#    K        ###  #
#          K       #
#    #####         #
#D         #    K  #
####################
####################
####################
####################
